╔══════════════════════════════════════════════════════════════════════════════════════════════════════════════════╗
║***^^^****************************************************************************************|====***************║
║***^^^***^^***********************************************************************************|***|***************║
║********^^^^**********************************************************************************|***|***************║
║********^^^^**************************************************************************************|***************║
║****^^**^^^^**********************************************************************************|***|***************║
║***^^^***^^***********************************************************************************|***|***************║
║***^^^****************************************************************************************|====***************║
║***^^^************************************************************************************************************║
║******************************************************************************************************************║
║******************************************************************************************************************║
║******************************************************************************************************************║
║******************************************************************************************************************║
║******************************************************************************************************************║
║******************************************************************************************************************║
║******************************************************************************************************************║
║******************************************************************************************************************║
╚══════════════════════════════════════════════════════════════════════════════════════════════════════════════════╝