╔═══════════════════════════════════════════════════════════════════════╗
║^^^^^^*************▓▓▓▓▓▓▓▓▓▓▓▓▓▓**************▓▓**************========║
║^^^^^^***^^********▓▓▓▓▓▓▓▓▓▓▓▓▓▓**************▓▓**************=*******║
║^^^*****^^^^*******▓▓▓▓▓▓▓▓▓▓▓▓▓▓************^^^^^^************=*******║
║********^^^^********▓▓▓▓▓▓▓▓▓▓▓▓*************^^^^^^********************║
║****^^**^^^^********============***************▓▓**************=*******║
║***^^^***^^*********=****==****=***************▓▓**************=*******║
║***^^^**************=****==****=***************▓▓**************========║
║***^^^*******************==********************▓▓**********************║
║********************=****==****=***************▓▓**********************║
║*****************^^^=****==****=***************▓▓**********************║
║***^^^^^******^^^^^^============***************▓▓**********************║
║***^^^^******^^^^^^^^^^^^^^********************≡≡**********************║
║***^^*********^^^^^^^^^^^^^^^******************▓▓**********************║
║^^*****==*==***^^^^^^^^^^^^^^^^^***************≡≡**********************║
║^^*****=***=*****^^^^^^^^^^^^^^^^^^************▓▓**********************║
╚═══════════════════════════════════════════════════════════════════════╝