╔══════════════════════════════════════════════════════════════════════════════════════════════════════════════════╗
║***^^^****************|====***************************************************************************************║
║***^^^***^^***********|***|***************************************************************************************║
║********^^^^**********|***|***************************************************************************************║
║********^^^^**************|***************************************************************************************║
║****^^**^^^^**********|***|***************************************************************************************║
║***^^^***^^***********|***|***************************************************************************************║
║***^^^****************|====***************************************************************************************║
║***^^^************************************************************************************************************║
║******************************************************************************************************************║
║******************************************************************************************************************║
║******************************************************************************************************************║
║******************************************************************************************************************║
║******************************************************************************************************************║
║******************************************************************************************************************║
║******************************************************************************************************************║
║******************************************************************************************************************║
╚══════════════════════════════════════════════════════════════════════════════════════════════════════════════════╝