****^^^****************
****^^^**********|====*
****^^^***^^*****|***|*
*********^^^^****|***|*
*********^^^^********|*
*****^^**^^^^****|***|*
****^^^***^^*****|***|*
****^^^**********|====*
****^^^****************   