╔═══════════════════════════════════════════════════════════════════════╗
║^^^^^^************▓▓▓▓▓▓▓▓*************************=====***************║
║^^^^^^***^^********▓▓▓▓▓▓▓*************************=***=***************║
║^^^*****^^^^*******▓▓▓▓▓▓▓*************************=***=***************║
║********^^^^********▓▓▓▓▓▓*****************************=***************║
║****^^**^^^^********======*************************=***=***************║
║***^^^***^^*********=****=*************************=***=***************║
║***^^^**************=****=*************************=====***************║
║***^^^*******************=*********************************************║
║********************=****=*********************************************║
║*****************^^^=****=*********************************************║
║***^^^^^******^^^^^^======*********************************************║
║***^^^^******^^^^^^^^^^^^^^********************************************║
║***^^*********^^^^^^^^^^^^^^^******************************************║
║^^*****==*==***^^^^^^^^^^^^^^^^^***************************************║
║^^*****=***=*****^^^^^^^^^^^^^^^^^^************************************║
╚═══════════════════════════════════════════════════════════════════════╝