'*','*','*','*','^','^','^','*','*','*','*','*','*','*','*','*','*','*','*','*','*','*','*'
'*','*','*','*','^','^','^','*','*','*','*','*','*','*','*','*','*','|','=','=','=','=','*'
'*','*','*','*','^','^','^','*','*','*','^','^','*','*','*','*','*','|','*','*','*','|','*'
'*','*','*','*','*','*','*','*','*','^','^','^','^','*','*','*','*','|','*','*','*','|','*'
'*','*','*','*','*','*','*','*','*','^','^','^','^','*','*','*','*','*','*','*','*','|','*'
'*','*','*','*','*','^','^','*','*','^','^','^','^','*','*','*','*','|','*','*','*','|','*'
'*','*','*','*','^','^','^','*','*','*','^','^','*','*','*','*','*','|','*','*','*','|','*'
'*','*','*','*','^','^','^','*','*','*','*','*','*','*','*','*','*','|','=','=','=','=','*'
'*','*','*','*','^','^','^','*','*','*','*','*','*','*','*','*','*','*','*','*','*','*','*'   