╔═══════════════════════════════════════════════════════════════════════╗
║^^^^^^*************▓▓▓▓▓▓▓▓▓▓▓▓▓▓**************▓▓*****=====****========║
║^^^^^^***^^********▓▓▓▓▓▓▓▓▓▓▓▓▓▓**************▓▓*****=***=****=*******║
║^^^*****^^^^*******▓▓▓▓▓▓▓▓▓▓▓▓▓▓************^^^^^^***==*==****=*******║
║********^^^^********▓▓▓▓▓▓▓▓▓▓▓▓*************^^^^^^********************║
║****^^**^^^^********============***************▓▓**************=*******║
║***^^^***^^*********=****==****=***************▓▓**************=*******║
║***^^^**************=****==****=***************▓▓**************========║
║***^^^*****************************************▓▓^^^^^====*============║
║********************=****==****=***************▓▓^^^^^=*******=*******=║
║*****************^^^=****==****=***************▓▓*^^**=*******=*******=║
║***^^^^^******^^^^^^============***************▓▓*****====*======***===║
║***^^^^******^^^^^^^^^^^^^^********************≡≡**********************║
║***^^*********^^^^^^^^^^^^^^^******************▓▓*********************^║
║^^*****==*==***^^^^^^^^^^^^^^^^^***************≡≡***************^^^^^^^║
║^^*****=***=*****^^^^^^^^^^^^^^^^^^************▓▓*************^^^^^^^^^║
╚═══════════════════════════════════════════════════════════════════════╝